111111111111111111
1P000000C0000*0001
101110111111011C01
1010*0010001010101
10*010111101010*01
10101010C001000001
1010111011110E1101
10100C000000010001
1C0*111111111*0001
100000*0000000C001
111111111111111111
